000000000000000000000000000000000000000000000000000000000000
000000000000000000000000000000000000000000000000000000000000
000000000000000000000000000000000000000000111110000000000000
000000000000000000000000000000000000000000000001000000000000
0000000000000000000000000000000000000000000000000000000000a0
000000000000000000000000000000000000000000000000000000000000
000000000000000000000000000000000000000000000000000000000000
000000000000000000000000000000000000000000000000000000000000
000000000000000000000000000000000000000000000000111111111111
000000000000000000000000000000000000000000000000000000000000
000000000000000000000000000000000000000011100000000000000000
000000000000000000000000000001111110000000000000000000000000
000000000000000000000000000010000000000000000000000000000000
0000000000000000000000000111000000000h0o00000000000000000000
0000000000000ccc00011100000000000011111111111110000000000000
000000000000000000000000000000000010000000000000000000000000
000000000000011100000000000000000010000000000000000000000000
000000000000000000000000000000000010000000000000000000000000
000000000000000000000000000000000010000000000000000000000000
222222222222222222222002222222222222222222222222222222222222