000000000000000000000000000000
000000000000000000000000000000
000000000000000000000000000000
000000000000000000000000000000
000000000000000000000000000000
000000000000000000000000011100
000000000000000000011100000000
000000000000000000000000000000
00000000000001110000000000000a
000000000000000000000000000000
000000000000000000000000000000
333333333333333333333333000000